1111111
10P0001
1C11C01
100E001
1000001
1111111