1111111111111
1C0100C0000C1
1M00011111CM1
1P0011EC000M11
1111111111111