1111111111111
10001M0000C11
1P0000E000001
1111111111111