11111111111111111111111111
1C1111C1111C11C1111C11M1C1
1C1111C1111C11C1111C1111C1
1CM111C1111C11C1111C1111C1
1CCCCCCCCCCCCCCCCCCCCCCCC1
1C1111C1C1M111111C1C1111C1
1CCCCCC1CCCC11CCCC1CCCCCC1
1M1111C11M101101111C111111
111111C100000000001C11M111
111111C10M110011101C111111
1ECCCCC001000000100CCCCC01
111111C101111111101C111111
111111C100000000001C111111
111111C101111111101C111111
1CCCCCCCCCCC11CCCCCCCCCCC1
1C1111C1111C11C1111C11M1C1
1CCC11CCCCCC0PCCCCCC11CCC1
111C11C1C11111111C1C11C111
1CCCCCCMCCCC11CCCC1CCCCCC1
1C11111M111C11C111111111C1
11111111111111111111111111