1111111111
11C0C00001
1C11MMC011
10M1001001
1P01101001
1100C0C0M1
1011C00001
1MM0010EC1
1C001MCCM1
1111111111