1111111111111111111111111111111111
1E0C0000C0001MCC00C00C0CMMC000C001
1C1C01010M1000001010010000M001M101
1010010011101010001001C0MCC001C101
1P0C0C000CMMC00000000MM00CC000C0C1
1111111111111111111111111111111111