11111111111111111111111111
1CCCCCCCCCCC11CCCCCCCCCCC1
1CM11MC1MM1C11C1111CM11MC1
1C1111C1111C11CM11MC1111C1
1CM11MC1MM1C11C1111CM11MC1
1CCCCCCCCCCCCCCCCCCCCCCCC1
1C1111C1C11111111C1C1111C1
1CCCCCC1CCCC11CCCC1CCCCCC1
11111MC111101101111CM11111
111111C100000000001C111111
11111MC101110011101CM11111
1ECCCCC00100MM00100CCCCC01
11M11MC101111111101C111111
111111C10MMM00MMM01CM11111
11M11MC101111111101C111111
1CCCCCCCCCCC11CCCCCCCCCCC1
1C1111C1111C11C1111CM111C1
1CCC11CCCCCC0PCCCCCC11CCC1
11MC11C1C11111111C1CM1C111
1CCCCCC1CCCC11CCCC1CCCCCC1
1C1M111M111C11C11111M111C1
1CCCCCCCCCCCCCCCCCCCCCCCC1
11111111111111111111111111