11111111111111111111111111
1CCCCCCCCCCC11CCCCCCCCCCC1
1C1111P1111C11C1111C1111C1
1C1111C1111C11C1111C1111C1
1C1111C1011C11C1111C1111C1
1CCCCC000CCCCCCCCCCCCCCCC1
11111111111110001111111111
1CCCCCC1CCCC11CCCC1CCCCCC1
111111C111101101111C111111
111111C100000000001C111111
1111111111111111111C111111
1ECCCCC001000000100CCCCC01
1CCC11CCCCCC0MCCCCCC11CCC1
11111111111111111111111111