1111111111111111111111111111111111
1PM0000MC0000000010C00100001000C01
1C00010M1M1110010M00001M10M1000011
10M1110100001001CMC00C001110001001
1000010100001100011M0110001C0M1001
1C111100010000C0010C010000111MC001
101000010M111M1111000100100CM00011
10111C01000000000M0001011000M01001
1010CC011M111M110110110100111010C1
1C1010000000000100M010010010001111
1011111M0001000100101011001E000001
1000C00111110101000010C11111MM0101
1C1010010C01C101011M1111MC0000C001
1111100M100101011100C000000100M001
1MCC0CC0C000010000011000M00100MCC1
1111111111111111111111111111111111